##########
#   vv   #
#        #
+   TT   #
#        #
#   ^^   #
##########