##########
# H vv   #
#        #
+  dTTD  #
#        #
#   ^^   #
#######+##
#        #
#=       #
#=       #
#   H  H #
##########